
      [console_scripts]
      kansha-admin = kansha.app:run

      [kansha.commands]
      alembic-current = kansha.alembic.admin:AlembicCurrentCommand
      alembic-downgrade = kansha.alembic.admin:AlembicDowngradeCommand
      alembic-revision = kansha.alembic.admin:AlembicRevisionCommand
      alembic-stamp = kansha.alembic.admin:AlembicStampCommand
      alembic-upgrade = kansha.alembic.admin:AlembicUpgradeCommand
      create-index = kansha.batch.create_index:ReIndex
      save-config = kansha.batch.save_config:SaveConfig
      create-demo = kansha.batch.create_demo:CreateDemo

      [kansha.services]
      authentication = kansha.services.authentication_repository:AuthenticationsRepository
      mail_sender = kansha.services.mail:MailSender
      assets_manager = kansha.services.simpleassetsmanager.simpleassetsmanager:SimpleAssetsManager

      [kansha.authentication]
      dblogin = kansha.authentication.database.forms:Login
      oauthlogin = kansha.authentication.oauth.forms:Login
      ldaplogin = kansha.authentication.ldap.forms:Login

      [kansha.card.extensions]
      labels = kansha.card_addons.label.comp:CardLabels
      description = kansha.card_addons.description.comp:CardDescription
      checklists = kansha.card_addons.checklist.comp:Checklists
      gallery = kansha.card_addons.gallery.comp:Gallery
      comments = kansha.card_addons.comment.comp:Comments
      due_date = kansha.card_addons.due_date.comp:DueDate
      votes = kansha.card_addons.vote.comp:Votes
      weight = kansha.card_addons.weight:CardWeightEditor
      members = kansha.card_addons.members:CardMembers

      [nagare.applications]
      kansha = kansha.app:app

      [search.engines]
      dummy = kansha.services.search.dummyengine:DummySearchEngine
      sqlite = kansha.services.search.sqliteengine:SQLiteFTSEngine
      elastic = kansha.services.search.elasticengine:ElasticSearchEngine
      